20,9,13,13,6,26,13,3,0,3
6,10,6,3,6,23,9,0,3,13
3,3,3,3,10,9,10,6,3,13
13,9,10,3,6,3,6,13,3,3
16,16,6,6,13,13,6,23,3,3
9,13,9,10,6,3,3,6,3,10
10,9,10,6,0,3,13,13,3,6
3,0,3,3,0,0,3,6,3,13
0,0,3,10,3,0,3,10,6,13
0,0,0,3,0,0,0,3,0,3
