0,3,10,3,3,3,0,0,0,0
0,0,3,6,13,16,3,0,0,0
3,0,3,10,9,13,3,0,0,3
10,6,3,3,3,3,3,0,3,13
9,23,13,9,10,6,10,3,3,13
20,9,6,10,6,0,6,0,0,3
6,23,6,6,0,3,13,6,3,0
3,19,19,13,3,6,16,26,13,3
3,26,16,6,3,10,6,3,3,0
0,3,3,0,0,3,0,0,0,0
