0,6,13,6,13,13,3,0,3,3
3,33,16,6,3,3,0,3,13,13
0,3,6,13,3,0,0,0,6,6
0,0,3,13,3,3,0,3,13,13
3,0,0,3,3,20,3,0,3,6
13,3,3,0,0,3,3,0,3,10
13,6,10,3,0,6,10,3,3,3
6,0,3,3,3,13,6,3,10,3
10,3,3,10,6,13,3,0,3,0
3,0,0,3,0,3,0,0,0,0
