0,0,6,10,6,13,3,0,0,0
0,3,13,6,3,13,3,0,3,0
3,3,26,6,3,6,0,3,10,3
10,6,16,19,26,13,6,0,3,0
3,0,9,13,6,6,10,6,0,0
0,3,23,9,0,0,6,10,3,0
0,3,16,16,3,3,3,6,0,3
3,0,6,16,6,16,16,13,6,10
10,3,3,13,6,23,6,3,0,3
3,0,0,3,0,3,0,0,0,0
