13,26,13,3,3,10,3,0,3,0
6,3,6,0,0,3,0,6,10,3
23,6,10,3,0,0,6,10,6,3
13,6,3,3,0,3,13,6,3,10
6,13,6,10,6,3,23,3,0,6
6,23,3,9,10,3,6,0,3,10
20,9,3,10,9,3,10,3,0,3
6,13,3,9,10,3,6,0,0,0
3,13,6,10,6,3,10,3,0,0
0,3,0,3,0,0,3,0,0,0
