0,3,13,6,3,10,3,0,3,0
0,3,19,13,3,3,0,6,13,3
3,3,16,6,0,3,3,13,19,6
10,9,13,3,6,13,3,9,19,16
6,23,6,6,23,16,9,13,19,19
3,13,6,13,9,6,10,6,6,13
0,3,3,19,13,6,6,3,0,3
3,0,6,36,12,16,19,13,6,0
10,6,13,29,16,19,26,9,10,3
3,0,3,3,3,3,3,0,3,0
