16,16,6,13,19,13,3,3,10,3
16,19,3,9,16,6,3,3,6,0
9,13,6,13,16,9,16,16,16,3
10,6,3,3,9,36,16,9,16,3
3,6,10,6,16,19,6,3,13,3
3,13,9,3,16,19,3,3,3,0
3,16,16,6,9,13,6,10,6,0
0,9,19,26,23,6,3,6,10,3
3,13,16,6,3,3,10,3,3,0
0,3,3,0,0,0,3,0,0,0
