3,10,6,6,16,13,6,10,3,3
0,6,13,16,19,6,0,3,3,10
3,3,6,9,13,3,0,3,0,3
16,16,29,13,6,3,3,10,3,0
16,9,13,9,3,20,3,3,0,0
13,3,6,10,3,6,0,0,0,0
3,0,3,3,3,13,6,0,0,0
3,3,10,3,3,19,13,6,0,0
10,3,3,0,3,13,9,10,3,0
3,0,0,0,0,3,0,3,0,0
