0,0,0,3,0,0,0,0,0,0
0,0,3,20,3,0,0,0,0,0
0,0,3,3,0,0,0,3,0,0
0,3,13,3,0,3,6,10,6,0
0,6,16,3,3,13,13,9,13,3
3,13,26,3,3,3,6,3,23,3
0,3,6,6,10,6,10,6,6,0
0,3,13,16,6,0,6,16,23,3
0,0,6,13,3,0,3,23,6,0
0,0,0,3,0,0,0,3,0,0
