10,3,0,3,10,3,6,13,3,0
6,0,0,0,6,6,16,19,6,0
10,6,0,6,16,16,22,22,13,3
9,10,9,13,19,12,26,19,6,0
10,9,13,9,16,13,9,13,6,0
3,6,16,3,3,3,0,6,10,3
3,23,19,3,0,0,0,0,6,3
0,6,13,3,3,0,0,3,13,16
0,0,3,3,20,3,0,0,6,13
0,0,0,0,3,0,0,0,0,3
