3,20,3,0,0,0,3,20,6,0
0,3,3,3,0,0,0,6,10,3
3,6,16,13,3,0,0,0,3,3
16,16,26,9,0,0,3,0,3,10
13,6,6,10,6,6,10,3,0,3
3,0,0,9,13,13,6,3,0,3
0,0,3,23,9,6,3,10,6,23
3,3,6,16,16,13,3,3,6,16
13,16,13,6,3,3,0,3,13,16
3,3,3,0,0,0,0,0,3,3
