6,10,6,3,3,16,29,13,6,0
13,9,16,16,6,16,26,9,10,3
13,6,16,16,3,3,3,3,3,0
3,0,3,3,3,3,6,10,6,3
0,3,0,3,23,16,16,12,26,13
3,23,6,3,6,9,16,19,16,6
3,16,19,16,26,13,9,13,6,0
0,6,26,6,3,6,0,3,3,0
0,3,13,3,3,10,3,3,10,3
0,0,3,0,0,3,0,0,3,0
