0,3,10,6,0,3,0,0,0,0
3,3,9,10,6,13,3,0,0,0
16,36,13,9,6,23,3,3,3,0
13,6,6,16,16,9,3,16,13,6
3,3,6,16,22,13,6,13,9,13
3,16,13,9,33,9,0,6,3,13
3,13,9,3,6,10,9,10,3,6
3,6,13,13,3,6,10,9,3,13
10,3,3,3,0,0,6,10,6,13
3,0,0,0,0,0,0,3,0,3
