6,10,6,23,3,3,3,16,23,3
10,9,3,13,6,20,6,13,6,0
6,20,3,6,0,6,3,6,0,0
3,3,3,10,6,13,16,13,6,0
10,6,0,6,3,3,3,6,10,6
6,20,6,13,23,3,0,0,9,10
3,6,3,6,6,0,3,6,13,6
16,19,19,16,16,6,13,16,16,3
16,19,16,9,13,3,3,3,3,0
3,3,3,0,3,0,0,0,0,0
