3,0,3,13,26,16,6,3,3,0
10,3,0,6,6,19,26,16,13,3
3,0,3,10,6,23,6,6,3,3
3,0,0,3,0,6,3,20,6,10
20,3,3,0,3,10,3,6,0,6
3,3,10,3,0,6,3,10,6,10
0,0,3,0,3,10,6,3,3,3
3,3,3,0,0,6,13,6,13,3
13,16,13,3,0,3,13,6,23,3
3,3,3,0,0,0,3,0,3,0
