3,13,13,6,0,0,3,10,3,3
0,3,6,10,3,0,0,3,3,10
0,0,0,6,3,0,0,0,3,3
0,0,3,13,13,3,3,3,13,3
0,0,0,6,6,6,20,6,13,6
0,0,3,16,16,26,9,0,6,10
0,3,3,16,9,16,13,6,0,3
3,20,6,23,3,3,6,30,6,0
0,3,0,3,0,0,0,6,10,3
0,0,0,0,0,0,0,0,3,0
