0,0,0,0,0,3,13,6,13,3
0,3,3,0,0,3,16,9,33,3
3,16,13,3,3,3,16,23,6,0
3,13,6,3,10,3,3,3,0,0
0,6,0,0,3,0,0,0,0,0
3,10,6,3,0,0,0,3,0,3
0,9,16,13,3,0,6,23,6,13
6,13,16,9,0,3,13,16,9,13
10,6,6,10,3,0,3,6,10,6
3,0,0,3,0,0,0,0,3,0
