0,0,3,26,16,13,6,0,3,3
0,0,6,26,6,6,13,6,16,13
0,3,13,16,3,3,13,6,16,6
3,0,3,3,3,3,6,6,13,6
13,3,3,3,13,16,16,13,12,23
26,6,10,3,3,3,3,6,16,19
13,3,3,0,0,0,0,3,26,16
3,3,0,3,3,3,3,3,3,6
3,10,6,13,26,16,16,13,6,20
0,3,0,3,3,3,3,3,0,3
