6,33,19,13,9,16,13,6,10,3
20,9,16,9,16,16,6,3,6,0
6,3,13,6,13,6,6,13,13,3
10,3,6,0,3,3,10,6,6,0
6,3,10,3,0,0,3,6,10,3
10,3,6,0,0,3,3,13,6,0
3,3,13,3,6,13,6,13,3,0
0,3,13,6,16,16,3,6,0,0
0,0,3,3,13,6,3,10,3,0
0,0,0,0,3,0,0,3,0,0
