10,6,0,3,16,29,19,23,3,0
9,10,6,6,16,22,26,6,0,0
20,9,13,13,9,13,6,3,0,3
3,3,3,3,0,3,6,10,6,23
6,13,6,0,3,3,10,6,3,13
13,19,13,6,10,3,3,3,3,3
3,3,6,0,3,3,6,13,26,3
3,3,10,6,3,13,13,12,16,3
10,3,6,20,3,3,6,13,16,3
3,0,0,3,0,0,0,3,3,0
