0,0,0,0,0,0,3,6,20,3
0,3,3,3,0,6,16,23,6,0
3,13,16,13,6,26,16,6,0,0
3,3,6,3,3,13,9,0,3,0
10,9,10,3,3,6,20,6,10,6
6,13,6,3,10,3,6,0,6,10
3,16,3,3,3,6,10,3,0,6
3,13,6,20,6,10,6,3,3,10
0,3,0,3,0,3,3,10,3,3
0,0,0,0,0,0,0,3,0,0
