3,3,10,3,0,3,0,3,10,3
13,3,3,3,3,10,3,0,3,3
13,6,3,20,3,6,3,0,3,20
6,13,6,3,6,13,16,3,0,6
3,16,13,6,10,9,13,6,3,10
0,3,3,0,6,0,6,13,3,6
3,0,0,3,13,3,3,23,6,10
10,3,0,6,16,3,3,3,0,3
3,0,3,13,16,6,10,3,0,0
0,0,0,3,3,0,3,0,0,0
