3,0,0,0,3,0,3,0,3,0
13,3,3,3,13,6,10,6,13,3
16,6,23,9,16,6,3,6,16,3
23,6,16,16,42,26,6,13,19,3
6,3,3,9,16,16,3,9,16,6
23,13,6,10,9,6,3,16,19,16
3,6,0,9,13,13,6,13,12,13
3,20,6,20,6,3,0,9,10,6
0,3,0,3,0,0,3,20,6,0
0,0,0,0,0,0,0,3,0,0
