10,6,20,6,0,3,0,3,10,3
6,0,6,13,6,10,3,3,3,0
10,6,3,13,6,3,3,10,6,0
6,23,3,6,10,3,0,6,10,3
3,13,3,0,3,3,0,0,3,3
0,3,3,0,3,20,6,0,6,10
0,3,10,6,0,9,10,6,10,6
0,0,6,13,6,10,6,0,3,3
0,0,3,13,3,3,0,0,3,10
0,0,0,3,0,0,0,0,0,3
