0,6,10,6,13,13,6,0,0,3
3,10,6,3,6,6,10,3,3,10
0,3,3,13,13,3,3,0,3,3
0,3,3,3,3,3,0,3,13,3
6,13,13,3,3,10,3,6,16,3
10,6,6,3,0,3,3,13,19,3
3,6,13,13,3,3,3,9,13,3
6,10,6,6,3,13,16,26,6,0
10,6,3,20,3,3,6,23,3,0
3,0,0,3,0,0,0,3,0,0
