0,0,3,6,33,6,0,0,0,0
3,3,16,16,29,13,6,0,0,0
10,9,13,9,3,6,10,3,0,0
6,13,12,13,3,0,3,3,0,3
3,19,16,16,6,0,6,13,6,10
6,13,6,6,10,9,13,16,3,3
10,9,3,0,6,13,6,3,3,0
9,13,16,3,3,13,3,3,10,6
10,9,13,3,0,3,0,0,6,10
3,0,3,0,0,0,0,0,0,3
