0,3,13,3,0,3,3,0,3,0
3,3,23,6,6,13,16,9,10,3
10,3,9,13,13,9,16,16,9,0
3,6,10,6,3,0,6,16,13,3
6,13,6,0,0,0,0,6,3,0
16,16,6,0,0,3,6,10,3,3
13,9,13,3,6,13,13,6,3,13
6,3,13,9,13,6,3,0,3,13
10,3,6,13,16,3,0,0,0,3
3,0,0,3,3,0,0,0,0,0
