13,3,3,13,13,3,3,16,13,3
13,3,3,6,3,0,6,23,6,0
3,3,16,16,3,6,10,6,0,0
3,3,29,19,9,10,9,0,0,0
10,9,16,22,16,12,20,6,0,0
9,10,12,16,19,13,9,20,6,0
10,9,13,6,3,3,3,6,10,3
3,3,16,3,3,3,13,6,3,3
0,3,13,6,10,6,36,13,6,10
0,0,3,0,3,0,3,3,0,3
