3,0,0,3,0,3,13,9,13,3
10,3,6,20,6,3,26,16,19,3
6,3,10,9,10,6,6,6,16,3
10,6,6,0,6,13,23,6,23,3
6,16,13,3,3,3,3,0,3,3
3,13,9,3,23,6,0,0,3,10
0,6,10,6,19,13,3,0,0,6
3,0,3,6,26,9,0,3,6,13
10,3,3,13,19,13,6,23,16,16
3,0,0,3,3,3,0,3,3,3
