13,6,0,3,0,3,0,3,0,0
19,13,6,13,6,10,6,10,6,0
13,6,3,16,6,6,0,6,10,3
3,0,3,16,29,13,3,0,3,0
0,3,3,6,16,6,0,0,0,3
6,13,16,6,13,6,3,3,3,20
23,12,13,3,6,16,19,16,6,3
16,16,6,0,3,19,22,22,16,3
6,13,3,0,3,16,19,19,16,3
0,3,0,0,0,3,3,3,3,0
