0,0,3,10,6,6,10,3,0,3
3,0,0,9,13,13,6,0,3,13
20,3,3,10,6,3,0,3,3,13
3,0,0,6,0,3,3,10,6,3
0,0,3,23,6,13,3,6,10,3
0,0,6,16,6,16,3,0,3,0
3,3,13,19,9,13,3,0,0,0
13,3,6,16,16,6,0,0,0,0
23,3,0,6,13,3,0,0,0,0
3,0,0,0,3,0,0,0,0,0
