13,3,0,0,3,10,3,0,0,0
13,6,0,0,0,3,3,0,0,0
6,20,3,3,3,3,13,3,0,0
3,3,6,16,16,6,16,6,0,0
13,9,13,19,16,9,19,13,3,3
29,26,6,6,9,13,19,9,3,10
19,19,9,13,13,9,16,23,3,3
16,19,16,9,3,3,3,3,3,0
3,6,26,13,6,10,3,3,10,3
0,0,3,3,0,3,0,0,3,0
