3,10,3,0,0,3,10,3,0,0
0,3,3,0,3,0,3,0,3,3
0,3,13,9,10,3,3,3,13,13
0,3,19,13,9,3,23,3,3,3
3,3,13,9,20,6,13,3,0,0
10,3,6,0,3,0,3,0,0,3
3,3,10,3,0,3,0,3,6,20
0,0,3,0,3,10,9,13,13,9
0,0,0,0,0,6,10,6,6,10
0,0,0,0,0,0,3,0,0,3
