20,6,23,3,3,23,19,16,3,3
3,6,13,3,0,6,16,16,6,10
3,10,6,0,0,0,3,6,3,6
0,3,3,0,3,0,3,23,16,13
0,6,13,6,10,3,0,6,3,6
3,26,19,3,3,0,3,10,6,20
6,16,19,3,3,3,3,3,0,3
13,9,13,9,13,16,13,3,0,3
13,3,6,10,6,3,3,0,3,10
3,0,0,3,0,0,0,0,0,3
