0,0,3,3,13,3,3,13,3,3
0,3,13,6,13,3,3,13,6,10
0,3,16,3,6,0,0,3,3,3
0,3,13,6,13,3,0,3,13,6
0,0,3,6,23,3,0,6,16,13
0,0,3,10,6,0,3,10,6,3
0,0,3,3,3,0,3,3,0,0
0,3,10,6,10,9,10,3,0,0
0,0,3,0,6,10,6,0,0,0
0,0,0,0,0,3,0,0,0,0
