3,0,0,6,10,6,0,3,0,0
13,3,3,10,9,13,6,10,3,0
16,3,0,3,3,13,3,6,0,0
13,3,0,0,0,3,3,23,6,0
3,3,0,3,0,0,3,16,13,3
6,13,9,10,3,3,0,3,3,0
13,19,16,6,3,10,3,3,0,0
3,6,13,3,0,6,6,10,6,3
0,0,3,0,3,13,13,9,13,13
0,0,0,0,0,3,3,0,3,3
