16,16,13,9,10,6,13,16,23,3
13,6,6,10,6,0,3,3,3,3
3,3,0,3,0,0,0,0,3,10
3,20,6,0,0,0,0,3,3,6
3,6,10,3,3,0,3,13,16,16
10,3,6,3,10,3,3,6,9,13
3,6,10,6,3,3,13,19,16,6
3,10,12,23,6,0,6,16,26,3
0,6,13,19,13,3,0,3,3,0
0,0,3,3,3,0,0,0,0,0
