13,23,9,13,3,0,0,6,13,3
6,6,23,16,6,3,3,23,19,3
20,6,6,9,13,16,3,9,16,3
6,26,26,13,9,23,9,13,16,3
3,13,9,3,0,6,10,6,6,0
0,6,10,6,0,3,3,6,10,3
3,3,6,10,9,23,6,10,6,3
13,13,6,6,16,19,3,6,3,10
3,6,10,6,16,16,6,10,3,3
0,0,3,0,3,3,0,3,0,0
