0,3,3,3,10,3,0,0,3,0
3,13,13,3,3,0,0,6,13,3
3,6,6,3,0,3,3,13,16,6
13,26,16,13,6,30,3,6,6,10
3,6,3,3,0,6,3,10,3,3
3,23,3,3,3,23,3,6,0,3
3,13,9,10,6,13,9,20,6,10
3,6,10,6,0,6,20,6,0,6
10,3,3,0,0,0,3,0,3,10
3,0,0,0,0,0,0,0,0,3
