23,3,3,20,3,3,0,0,0,3
13,3,0,3,6,13,3,0,3,13
3,3,0,3,16,19,6,0,3,23
6,13,3,3,16,19,16,3,0,6
16,19,6,3,3,6,13,3,3,10
19,19,16,16,3,0,6,0,0,3
16,6,6,13,3,3,10,3,0,0
13,3,3,3,3,3,3,0,0,0
3,3,10,6,13,23,3,0,0,0
0,0,3,0,3,3,0,0,0,0
