23,6,16,13,3,3,3,10,3,0
13,6,16,9,3,13,6,3,0,0
3,3,26,13,9,16,16,3,0,0
0,3,6,6,23,12,13,3,3,0
6,13,13,6,29,16,6,6,20,3
20,6,3,6,16,16,6,10,9,3
3,0,6,10,6,6,0,6,16,13
3,3,10,9,6,13,3,3,16,6
10,3,6,13,36,16,3,3,13,3
3,0,0,3,3,3,0,0,3,0
