0,3,30,3,6,13,3,3,0,0
0,0,6,3,23,16,6,10,3,0
0,6,13,6,3,3,0,3,0,0
3,13,22,26,6,0,0,0,0,0
0,6,16,19,13,3,0,0,0,3
0,0,3,3,6,0,3,0,3,10
0,0,0,3,13,6,23,3,0,6
0,0,0,3,13,6,26,6,3,20
0,0,0,0,3,3,26,13,3,3
0,0,0,0,0,0,3,3,0,0
