0,3,13,23,3,0,3,0,0,3
0,3,6,3,0,3,10,3,3,10
3,13,13,6,0,0,3,3,3,3
3,3,6,10,3,3,3,16,26,6
10,3,0,6,3,13,9,19,19,13
3,0,3,20,9,16,16,16,9,6
3,0,3,6,10,9,6,9,13,16
10,6,10,6,6,13,16,13,9,16
3,0,6,10,3,3,3,3,3,13
0,0,0,3,0,0,0,0,0,3
