16,13,6,3,3,0,3,3,3,0
13,9,13,19,13,6,16,16,13,3
6,0,9,16,9,6,13,6,3,0
10,6,16,19,19,23,6,0,0,0
3,3,13,12,13,6,0,0,3,3
3,0,6,10,6,3,0,3,13,13
13,3,3,6,6,10,3,0,3,3
13,6,13,16,13,6,3,0,0,3
3,0,3,3,3,3,10,3,3,20
0,0,0,0,0,0,3,0,0,3
